0 0 0 0 0 0 0 0 0 0 0 0 0 0 0 0 0 0 0 0 0 0 0 0 0 0 0 0 0 0 0 0 0 0 0 0 0 0 0 0 0 0 0 0 0 0 0 0 0 0 
0 0 0 0 0 0 0 0 0 0 0 0 3 16 16 16 16 16 16 16 16 16 16 16 16 16 16 16 16 5 0 0 0 0 0 0 0 0 0 0 0 0 0 0 0 0 0 0 0 0 
0 0 0 0 0 0 0 0 0 0 0 0 4 2 2 2 2 2 2 2 2 2 2 2 2 2 2 2 2 6 0 0 0 0 0 0 0 0 0 0 0 0 0 0 0 0 0 0 0 0 
0 0 0 0 0 0 0 0 0 0 0 0 4 7 12 12 12 12 12 12 12 12 12 12 12 12 12 12 12 6 0 0 0 0 0 0 0 0 0 0 0 0 0 0 0 0 0 0 0 0 
0 0 0 0 0 0 0 0 0 0 0 0 4 7 13 11 11 11 9 9 11 11 11 11 11 9 9 11 15 6 0 0 0 0 0 0 0 0 0 0 0 0 0 0 0 0 0 0 0 0 
0 0 0 0 0 0 0 0 0 0 0 0 4 7 13 11 11 11 9 9 11 11 11 11 11 9 9 11 15 6 0 0 0 0 0 0 0 0 0 0 0 0 0 0 0 0 0 0 0 0
0 0 0 0 0 0 0 0 0 0 0 0 4 7 13 11 11 11 11 11 11 11 11 11 11 11 11 11 15 6 0 0 0 0 0 0 0 0 0 0 0 0 0 0 0 0 0 0 0 0
0 0 0 0 0 0 0 0 0 0 0 0 4 7 13 11 11 11 11 11 11 11 11 11 11 11 11 11 15 6 0 0 0 0 0 0 0 0 0 0 0 0 0 0 0 0 0 0 0 0
0 0 0 0 0 0 0 0 0 0 0 0 4 7 13 11 11 11 11 11 11 11 11 11 11 11 11 11 15 6 0 0 0 0 0 0 0 0 0 0 0 0 0 0 0 0 0 0 0 0
0 0 0 0 0 0 0 0 0 0 0 0 4 7 13 11 11 11 11 11 11 11 11 11 11 11 11 11 15 1 1 1 1 1 1 1 1 1 1 1 1 5 0 0 0 0 0 0 0 0
0 0 0 0 0 0 0 0 0 0 0 0 4 7 13 11 9 9 11 11 11 11 11 9 9 11 11 11 11 11 11 11 11 11 11 11 11 11 11 11 11 6 0 0 0 0 0 0 0 0
0 0 0 0 0 0 0 0 0 0 0 0 4 7 13 11 9 9 11 11 11 11 11 9 9 11 11 11 15 1 1 1 1 1 1 1 1 1 1 5 11 6 0 0 0 0 0 0 0 0
0 0 0 0 0 0 0 0 0 0 0 0 4 7 14 14 14 14 14 14 14 14 14 14 14 14 14 14 14 6 0 0 0 0 0 0 0 0 0 6 11 6 0 0 0 0 0 0 0 0
0 0 0 0 0 0 0 0 0 0 0 0 1 1 1 1 1 1 1 1 1 1 1 1 1 1 1 1 1 1 0 0 0 0 0 0 0 0 0 6 11 6 0 0 0 0 0 0 0 0
0 0 0 0 0 0 0 0 0 0 0 0 0 0 0 0 0 0 0 0 0 0 0 0 0 0 0 0 0 0 0 0 0 0 0 0 0 0 0 6 11 6 0 0 0 0 0 0 0 0
0 0 0 0 0 0 0 0 0 0 0 0 0 0 0 0 0 0 0 0 0 0 0 0 0 0 0 0 3 1 1 1 1 1 1 1 1 1 1 6 11 6 5 0 0 0 0 0 0 0
0 0 0 0 0 0 0 0 0 0 0 0 0 0 0 0 0 0 0 0 0 0 0 0 0 0 0 0 4 12 12 12 12 12 12 12 12 12 12 11 11 12 6 0 0 0 0 0 0 0
0 0 0 0 0 3 1 1 1 1 1 1 1 1 1 1 1 1 1 1 1 1 1 5 0 0 0 0 4 13 11 11 11 11 11 11 11 11 11 11 11 15 6 0 0 0 0 0 0 0
0 0 0 0 0 4 12 12 12 12 12 12 12 12 12 12 12 12 12 12 12 12 12 6 0 0 0 0 4 13 11 11 11 11 11 9 11 11 11 11 11 11 6 0 0 0 0 0 0 0
0 0 0 0 0 4 13 11 11 11 11 11 11 11 11 11 9 11 11 11 11 11 15 6 0 0 0 0 4 13 11 11 11 11 11 11 11 11 11 11 11 15 6 0 0 0 0 0 0 0
0 0 0 0 0 4 13 11 11 11 11 11 11 11 11 11 11 11 11 11 11 11 15 6 0 0 0 0 4 13 11 11 11 11 11 11 11 11 11 11 11 15 6 0 0 0 0 0 0 0
0 0 0 0 0 4 13 11 11 11 11 11 11 11 11 11 11 11 11 11 11 11 15 6 0 0 0 0 4 13 11 11 11 11 11 11 11 11 11 11 9 15 6 0 0 0 0 0 0 0
0 0 0 0 0 4 13 11 11 11 11 11 11 11 11 11 11 11 11 11 11 11 15 6 0 0 0 0 4 13 11 9 11 11 11 11 11 11 11 11 11 15 6 0 0 0 0 0 0 0
0 0 0 0 0 4 13 11 11 11 11 11 9 11 11 11 11 11 11 11 11 11 11 1 1 1 1 1 1 13 11 11 11 11 11 11 11 11 11 11 11 15 6 0 0 0 0 0 0 0
0 0 0 0 0 4 13 11 11 11 11 11 11 11 11 11 11 11 11 11 11 11 11 11 11 11 11 11 11 11 11 11 11 11 11 11 11 11 11 11 11 15 6 0 0 0 0 0 0 0
0 0 0 0 0 4 14 14 14 14 14 14 14 14 14 14 14 14 14 14 14 14 14 1 1 1 1 1 4 14 14 11 14 14 14 14 14 14 14 14 14 14 6 0 0 0 0 0 0 0
0 0 0 0 0 1 1 1 1 1 1 1 1 1 1 1 1 1 1 1 1 1 1 1 0 0 0 0 1 1 1 11 1 1 1 1 1 1 1 1 1 1 1 0 0 0 0 0 0 0
0 0 0 0 0 0 0 0 0 0 0 0 0 0 0 0 0 0 0 0 0 0 0 0 0 0 0 0 0 0 6 11 6 0 0 0 0 0 0 0 0 0 0 0 0 0 0 0 0 0
0 0 0 0 0 0 0 0 0 0 0 0 0 0 0 0 0 0 0 0 0 0 0 0 0 0 0 0 0 3 1 11 1 1 1 1 1 1 1 1 1 1 5 0 0 0 0 0 0 0
0 0 0 0 0 0 0 0 0 0 0 0 0 0 0 0 0 0 0 0 0 0 0 0 0 0 0 0 0 4 12 12 12 12 12 12 12 12 12 12 12 12 6 0 0 0 0 0 0 0
0 0 0 0 0 0 0 0 0 0 0 0 0 0 0 0 0 0 0 0 0 0 0 0 0 0 0 0 0 4 13 11 11 11 11 11 11 11 11 11 11 15 6 0 0 0 0 0 0 0
0 0 0 0 0 0 0 0 0 0 0 0 0 0 0 0 0 0 0 0 0 0 0 0 0 0 0 0 0 4 13 11 9 11 11 11 11 11 11 11 11 15 6 0 0 0 0 0 0 0
0 0 0 0 0 0 0 0 0 0 0 0 0 0 0 0 0 0 0 0 0 0 0 0 0 0 0 0 0 4 13 11 11 11 11 11 11 11 11 11 11 15 6 0 0 0 0 0 0 0
0 0 0 0 0 0 0 0 0 0 0 0 0 0 0 0 0 0 0 0 0 0 0 0 0 0 0 0 0 4 13 11 11 11 11 11 11 11 11 11 11 15 6 0 0 0 0 0 0 0
0 0 0 0 0 0 0 0 0 0 0 0 0 0 0 0 0 0 0 0 0 0 0 0 0 0 0 0 0 4 13 11 11 11 11 11 11 11 9 11 11 15 6 0 0 0 0 0 0 0
0 0 0 0 0 0 0 0 0 0 0 0 0 0 0 0 0 0 0 0 0 0 0 0 0 0 0 0 0 4 13 11 11 11 11 11 11 11 11 11 11 15 6 0 0 0 0 0 0 0
0 0 0 0 0 0 0 0 0 0 3 1 1 1 1 1 1 1 1 1 1 1 1 1 5 0 0 0 0 4 14 14 14 14 14 14 14 14 14 14 14 14 6 0 0 0 0 0 0 0
0 0 0 0 0 0 0 0 0 0 4 12 12 12 12 12 12 12 12 12 12 12 12 12 16 0 0 0 0 1 1 1 1 1 1 1 1 1 1 1 11 1 1 0 0 0 0 0 0 0
0 0 0 0 0 0 0 0 0 0 4 13 11 11 11 11 11 11 11 11 11 11 11 15 16 0 0 0 0 0 0 0 0 0 0 0 0 0 0 4 11 6 0 0 0 0 0 0 0 0
0 0 0 0 0 0 0 0 0 0 4 13 11 11 9 11 11 11 11 11 11 11 11 15 16 0 0 3 1 1 1 1 1 1 1 1 1 1 1 1 11 16 5 0 0 0 0 0 0 0
0 0 0 0 0 0 0 0 0 0 4 13 11 11 11 11 11 11 11 11 11 11 11 15 16 0 0 4 12 12 12 12 12 12 12 12 12 12 12 12 12 12 6 0 0 0 0 0 0 0
0 0 0 0 0 0 0 0 0 0 4 13 11 11 11 11 11 11 11 9 11 11 11 15 16 0 0 4 13 11 9 11 11 11 11 11 11 11 11 11 11 15 6 0 0 0 0 0 0 0
0 0 0 0 0 0 0 0 0 0 4 13 11 11 11 11 11 11 11 11 11 11 11 15 16 0 0 4 13 11 11 11 11 11 11 11 11 11 11 11 11 15 6 0 0 0 0 0 0 0
0 0 0 0 0 0 0 0 0 0 4 13 11 11 11 11 11 11 11 11 11 11 11 15 16 0 0 4 13 11 11 11 11 11 11 11 11 11 9 11 11 15 6 0 0 0 0 0 0 0
0 0 0 0 0 0 0 0 0 0 4 13 11 11 11 11 11 11 11 11 11 11 11 15 16 1 1 1 13 11 11 11 11 11 11 11 11 11 11 11 11 15 6 0 0 0 0 0 0 0
0 0 0 0 0 0 0 0 0 0 4 13 11 11 11 11 11 11 11 11 11 11 11 11 14 14 14 14 14 14 14 14 14 14 14 14 14 14 14 14 14 14 6 0 0 0 0 0 0 0 
0 0 0 0 0 0 0 0 0 0 4 14 14 14 14 14 14 14 14 14 14 14 14 14 6 1 1 1 1 1 1 1 1 1 1 1 1 1 1 1 1 1 1 0 0 0 0 0 0 0 
0 0 0 0 0 0 0 0 0 0 1 1 1 1 1 1 1 1 1 1 1 1 1 1 1 0 0 0 0 0 0 0 0 0 0 0 0 0 0 0 0 0 0 0 0 0 0 0 0 0 
0 0 0 0 0 0 0 0 0 0 0 0 0 0 0 0 0 0 0 0 0 0 0 0 0 0 0 0 0 0 0 0 0 0 0 0 0 0 0 0 0 0 0 0 0 0 0 0 0 0