19 19 19 19 19 19 19 19 19 19 19 19 19 19 19 19 23 23 23 23 23 23 23 23 23 23 23 23 23 23 23 23 23 23 23 19 19 19 22 0 0 0 0 0 0 0 0 0 0 0 
19 19 19 23 23 23 23 23 23 23 23 23 19 19 19 22 29 24 24 24 24 24 24 24 24 24 24 24 24 24 24 24 24 24 30 21 19 19 22 0 0 0 0 0 0 0 0 0 0 0 
19 19 22 0 0 0 0 0 0 0 0 0 21 19 19 22 25 33 33 33 33 33 33 33 33 33 33 33 33 33 33 33 33 33 26 21 19 19 22 0 0 0 0 0 0 0 0 0 0 0 
19 19 22 0 0 0 0 0 0 0 0 0 21 19 19 22 25 33 33 33 33 33 33 33 33 33 33 33 33 33 33 33 33 33 26 21 19 19 22 0 0 0 0 0 0 0 0 0 0 0 
23 23 39 0 0 0 0 0 0 0 0 0 21 19 19 22 25 1 5 5 5 5 5 5 5 5 5 5 5 5 5 5 5 2 26 21 19 19 19 20 20 20 20 20 20 20 20 20 20 20
0 0 0 0 0 0 0 0 0 0 0 0 21 19 19 22 25 6 9 9 11 17 9 9 9 9 10 9 17 9 9 9 10 8 26 21 19 19 19 19 19 19 19 19 19 19 19 19 19 19
0 0 0 0 0 0 0 0 0 0 0 0 21 19 19 22 25 6 9 9 9 9 11 9 9 17 9 9 9 9 9 9 9 8 26 41 23 23 23 23 23 23 23 23 23 23 23 19 19 19
20 20 20 20 20 20 20 20 20 20 20 20 19 19 19 22 25 6 9 9 9 9 9 9 9 9 9 9 9 9 10 9 9 8 44 24 24 24 24 24 24 24 24 24 24 24 30 21 19 19
19 19 19 19 19 19 19 19 19 19 19 19 19 19 19 22 25 6 11 9 9 9 9 9 10 9 9 9 9 9 9 9 17 8 13 12 13 12 13 12 13 12 13 12 13 12 26 21 19 19
19 19 19 19 19 19 19 19 19 19 19 19 19 19 19 22 25 6 9 9 9 9 9 9 9 9 9 9 10 9 9 9 9 8 47 24 24 24 24 24 24 24 24 24 30 14 26 21 19 19
23 23 23 23 23 23 23 23 23 23 23 23 23 23 19 22 25 6 9 17 10 17 9 9 9 9 9 9 9 9 9 9 9 8 26 40 20 20 20 20 20 20 20 38 26 12 26 21 19 19
0 0 0 0 0 0 0 0 0 0 0 0 0 0 21 22 25 3 7 7 7 7 7 7 7 10 7 7 7 7 7 17 7 4 26 21 19 19 19 19 19 19 19 22 26 14 26 21 19 19
0 0 0 0 0 0 0 0 0 0 0 0 0 0 21 22 31 27 27 27 27 27 27 27 27 27 27 27 27 27 27 27 27 27 32 21 19 19 19 19 19 19 19 22 26 12 26 21 19 19
0 0 0 0 0 0 0 0 0 0 0 0 0 0 21 19 20 20 20 20 20 20 20 20 20 20 20 20 20 20 37 37 37 37 37 23 23 23 23 23 23 23 23 39 26 14 26 41 23 19
0 0 0 0 0 0 0 0 0 0 0 0 0 0 21 19 19 19 19 19 19 19 19 23 23 23 23 19 19 22 29 24 24 24 24 24 24 24 24 24 24 24 24 24 48 12 44 24 30 21
20 20 20 20 20 20 20 20 20 20 20 20 20 20 19 19 19 19 19 19 19 19 22 0 0 0 0 21 19 22 25 1 5 5 5 5 5 5 5 5 5 5 5 5 5 5 5 2 26 21
19 19 23 23 23 23 23 23 23 23 23 23 23 23 23 23 23 23 23 23 19 19 22 0 0 0 0 21 19 22 25 11 9 7 7 9 10 9 10 9 10 9 10 9 10 9 10 8 26 21
19 22 29 24 24 24 24 24 24 24 24 24 24 24 24 24 24 24 24 30 21 19 22 0 0 0 0 21 19 22 25 6 8 29 30 6 9 10 9 10 9 10 9 10 9 10 9 8 26 21
19 22 25 33 33 33 33 33 33 33 33 33 33 33 33 33 33 33 33 26 21 19 22 0 0 0 0 21 19 22 25 6 11 25 26 6 10 9 10 9 10 9 10 9 10 9 10 8 26 21
19 22 25 1 5 5 5 5 5 5 5 5 5 5 5 5 5 5 2 26 21 19 22 0 0 0 0 21 19 22 25 6 8 25 26 6 9 10 9 10 9 10 9 10 9 10 9 8 26 21
19 22 25 6 9 18 9 9 9 9 9 18 9 9 9 9 9 18 8 26 21 19 19 20 20 20 20 19 19 22 25 6 8 25 26 6 10 9 10 9 10 9 10 9 10 9 10 8 26 21
19 22 25 6 9 9 9 9 9 18 9 9 9 13 13 13 9 9 8 26 21 19 19 19 19 19 19 19 19 22 25 10 8 25 26 6 9 10 9 10 9 10 9 10 9 10 9 8 26 21
19 22 25 6 9 9 9 9 9 9 9 9 9 13 16 13 9 9 8 26 41 23 23 23 23 23 23 23 23 39 25 6 8 25 26 3 7 9 7 7 7 7 7 7 7 7 7 4 26 21
19 22 25 6 9 9 14 14 14 9 9 9 9 13 13 13 9 9 8 44 24 24 24 24 24 24 24 24 24 24 24 6 8 25 26 27 42 9 43 27 27 27 27 27 27 27 27 27 32 21
19 22 25 6 9 9 14 16 14 9 9 9 9 9 9 9 9 9 9 9 14 5 14 7 14 5 14 7 14 5 14 7 4 25 26 40 26 10 26 40 20 20 20 20 20 20 20 20 20 19
19 22 25 6 18 9 14 14 14 9 9 18 9 9 9 9 18 9 8 43 27 27 27 27 27 27 27 27 27 27 27 27 27 25 26 21 26 9 26 21 19 19 19 19 19 19 19 19 19 19
19 22 25 3 7 7 7 7 7 7 7 7 7 7 7 7 7 7 4 26 40 20 20 20 20 20 20 20 20 20 20 20 20 20 20 19 26 10 26 21 19 19 19 19 19 19 19 19 19 19
19 22 31 27 27 27 27 27 27 27 27 27 27 27 27 27 27 27 27 32 21 19 23 23 23 23 23 23 23 23 19 19 23 23 23 23 26 9 26 41 23 23 23 23 23 23 23 23 19 19
19 19 20 20 20 20 20 20 20 20 20 20 20 20 20 20 20 20 20 20 19 22 0 0 0 0 0 0 0 0 21 22 29 24 24 24 48 10 44 24 24 24 24 24 24 24 24 30 21 19
19 23 23 23 23 23 23 23 23 23 19 19 23 23 19 19 19 19 19 19 19 22 0 0 0 0 0 0 0 0 21 22 25 1 5 5 5 9 5 5 5 5 5 5 5 5 2 26 21 19
22 29 24 24 24 24 24 24 24 30 21 22 0 0 21 19 19 23 23 23 19 22 0 0 0 0 0 0 0 0 21 22 25 6 9 17 9 9 17 9 9 17 9 9 17 9 8 26 21 19
22 25 1 5 5 5 5 5 2 26 21 22 0 0 21 19 22 0 0 0 21 22 0 0 0 0 0 0 0 0 21 22 25 6 9 9 9 9 9 9 9 9 9 9 9 9 8 26 21 19
22 25 6 13 13 13 13 13 8 26 21 22 0 0 21 19 22 0 0 0 21 22 0 0 0 0 0 0 0 0 21 22 25 6 17 9 9 9 9 17 17 9 9 9 9 17 8 26 21 19
22 25 6 13 13 13 13 13 8 26 21 22 0 0 21 19 19 20 20 20 19 19 20 20 20 20 20 20 20 20 19 22 25 6 17 9 9 9 9 17 17 9 9 9 9 17 8 26 21 19
22 25 6 13 9 9 9 13 8 26 21 22 0 0 21 19 23 23 23 23 23 23 23 23 23 23 23 23 19 19 19 22 25 6 9 9 9 9 9 9 9 9 9 9 9 9 8 26 21 19
22 25 6 13 9 9 9 13 8 26 21 22 0 0 21 22 29 24 24 24 24 24 24 24 24 24 24 30 21 19 19 22 25 6 9 17 9 9 17 9 9 17 9 9 17 9 8 26 21 19
22 25 6 13 9 9 9 13 8 26 21 22 0 0 21 22 25 1 5 5 5 5 5 5 5 5 2 26 21 19 19 22 25 3 7 7 7 7 7 7 7 7 7 7 9 7 4 26 21 19
22 25 6 13 13 13 13 13 8 26 21 19 20 20 19 22 25 6 14 14 14 9 9 9 9 9 8 26 21 19 19 22 31 27 27 27 27 27 27 27 27 27 27 42 12 43 27 32 21 19
22 25 6 13 9 9 9 13 8 26 41 23 23 23 23 39 25 6 14 17 14 9 9 9 9 9 8 26 21 19 19 19 20 20 20 20 20 20 20 20 20 20 38 26 9 26 40 20 19 19
22 25 6 13 9 9 9 13 8 44 24 24 24 24 24 24 46 6 14 14 14 9 9 14 14 14 8 26 21 19 23 23 23 19 19 23 23 23 23 23 23 23 39 26 12 26 41 23 23 19
22 25 6 13 9 9 9 13 13 13 13 13 13 13 13 13 13 13 13 9 9 9 9 14 9 14 8 26 21 22 0 0 0 21 22 29 24 24 24 24 24 24 24 48 9 44 24 24 30 21
22 25 6 13 13 13 13 13 8 43 27 27 27 27 27 27 45 6 13 9 9 9 9 14 14 14 8 26 21 22 0 0 0 21 22 25 1 5 5 5 5 5 5 5 12 5 5 2 26 21
22 25 6 13 13 13 13 13 8 26 40 20 20 20 20 38 25 6 14 14 14 9 9 9 9 9 8 26 21 22 0 0 0 21 22 25 6 11 9 9 9 11 11 9 9 9 11 8 26 21
22 25 3 7 7 7 7 7 4 26 21 19 23 23 19 22 25 6 14 9 14 9 9 9 9 9 8 26 21 19 20 20 20 19 22 25 6 9 11 9 11 9 9 11 9 11 9 8 26 21
22 31 27 27 27 27 27 27 27 32 21 22 0 0 21 22 25 6 14 14 14 9 9 14 14 14 8 26 21 19 19 19 19 19 22 25 6 9 9 11 9 9 9 9 11 9 9 8 26 21
19 20 20 20 20 20 20 20 20 20 19 22 0 0 21 22 25 6 9 9 9 9 9 14 17 14 8 26 41 23 23 23 23 23 39 25 6 9 11 9 11 9 9 11 9 11 9 8 26 21
19 19 23 23 23 23 23 23 23 23 23 23 20 20 19 22 25 6 9 9 9 9 9 14 14 14 8 44 24 24 24 24 24 24 24 46 6 11 9 9 9 11 11 9 9 9 11 8 26 21
19 22 0 0 0 0 0 0 0 0 0 0 21 19 19 22 25 3 7 7 7 7 7 7 7 7 7 7 7 5 7 5 7 5 7 5 7 7 7 7 7 7 7 7 7 7 7 4 26 21
19 22 0 0 0 0 0 0 0 0 0 0 21 19 19 22 31 42 42 42 42 42 42 42 42 42 42 42 42 42 42 42 42 42 42 42 42 42 42 42 42 42 42 42 42 42 42 42 32 21
19 19 20 20 20 20 20 20 20 20 20 20 19 19 19 19 20 20 20 20 20 20 20 20 20 20 20 20 20 20 20 20 20 20 20 20 20 20 20 20 20 20 20 20 20 20 20 20 20 19