76 76 76 76 76 76 76 76 76 76 76 76 76 76 76 76 76 76 76 76 76 76 76 76 76 76 76 76 76 76 76 76 76 76 76 76 76 76 76 76 76 76 76 76 76 76 76 76 76 76 
76 76 76 76 76 76 76 76 76 76 76 76 76 76 76 76 76 76 76 76 76 76 76 76 76 76 76 76 76 76 75 76 76 76 76 76 76 76 76 76 76 76 76 76 76 76 76 76 76 76 
76 76 75 76 76 76 76 76 76 76 76 76 76 75 76 76 76 76 76 75 76 76 76 76 76 76 76 76 76 76 76 76 76 75 76 76 76 76 76 76 76 74 74 74 74 74 74 76 76 76 
76 76 76 76 76 76 76 76 75 76 76 76 76 76 76 76 76 76 76 76 76 76 76 76 75 76 76 76 76 76 76 76 76 76 76 76 76 75 76 76 76 76 76 76 76 76 76 76 76 76 
76 76 76 76 76 76 76 69 69 69 69 69 69 69 69 69 69 69 69 69 69 69 69 69 69 69 69 69 69 69 69 69 69 69 69 69 69 69 69 69 69 76 76 76 76 76 76 76 76 76 
76 76 76 76 76 76 71 50 50 50 50 54 54 54 54 54 54 54 54 54 54 54 54 54 54 54 54 54 54 54 54 54 54 54 54 54 54 54 54 54 53 73 76 76 75 76 76 76 76 76 
76 76 76 76 76 68 50 50 50 50 50 54 53 53 53 53 53 53 53 53 53 53 53 53 53 54 54 56 60 60 60 60 60 60 60 60 60 58 54 54 53 53 67 76 76 76 76 76 76 76 
76 76 76 76 76 68 50 50 50 50 50 54 53 53 53 53 53 53 53 53 53 53 53 53 53 54 54 61 64 64 64 64 64 64 64 64 64 62 54 54 53 53 67 76 76 76 76 75 76 76 
74 74 76 76 76 68 50 50 50 50 50 54 53 53 53 53 53 53 53 53 53 53 53 53 53 54 54 61 64 64 64 64 64 64 64 64 64 62 54 54 53 53 67 76 76 76 76 76 76 76 
76 76 76 76 76 68 50 50 50 50 50 54 53 53 53 53 53 53 53 53 53 53 53 53 53 54 54 61 64 64 64 64 65 64 64 64 64 62 54 54 53 53 67 76 76 76 76 76 76 76 
76 76 76 75 76 68 50 50 54 54 54 54 53 53 53 53 53 51 51 53 53 53 53 53 53 54 54 61 64 64 64 64 64 64 64 64 64 62 54 54 53 53 67 76 74 74 74 74 76 76 
76 76 76 76 76 68 50 54 54 53 53 53 53 53 53 53 51 51 51 53 53 53 53 53 53 54 54 61 64 64 64 64 64 64 64 64 64 62 54 54 53 53 67 76 76 76 76 76 76 76 
76 76 76 76 76 68 54 54 53 53 53 53 53 53 53 53 51 51 53 53 53 53 53 53 53 54 54 57 63 63 63 63 55 63 63 63 63 59 54 54 53 53 67 76 76 76 76 76 76 76 
75 76 75 76 76 68 53 53 53 53 53 53 53 51 51 51 51 51 51 51 51 53 53 53 53 54 54 54 54 54 54 52 55 52 54 54 54 54 54 54 53 53 67 76 76 76 75 76 75 76 
76 76 76 76 76 68 53 53 53 53 53 53 53 51 51 51 51 51 51 51 51 53 53 53 53 52 52 52 52 52 52 52 55 52 52 52 52 52 52 54 53 53 67 76 76 76 76 76 76 76 
76 76 76 76 76 68 53 53 53 53 53 53 53 51 51 51 54 54 51 51 51 53 53 53 53 53 53 53 53 53 53 52 55 52 53 53 53 53 53 51 53 53 67 76 76 76 76 76 76 76 
76 76 76 76 76 68 53 53 53 53 53 53 53 51 51 51 54 54 51 51 51 53 53 53 53 53 53 53 53 53 53 52 55 52 53 53 53 53 53 51 53 53 67 74 74 74 76 76 76 76 
76 76 76 76 76 68 53 53 53 53 53 53 53 51 51 51 51 51 51 51 51 53 53 53 53 53 53 53 53 53 53 52 55 52 53 53 53 53 53 51 53 53 67 76 76 76 76 76 76 76 
76 76 76 76 76 68 53 53 53 53 53 53 53 51 51 51 51 51 51 51 51 53 53 53 53 53 53 53 53 53 53 52 55 52 53 53 53 53 53 51 51 53 67 76 76 76 76 76 76 76 
76 74 74 74 76 68 53 53 53 53 53 53 53 53 53 53 53 53 53 53 53 53 53 53 53 53 53 53 53 53 53 52 55 52 53 53 53 53 53 51 51 53 67 76 76 76 75 75 75 76 
76 76 76 76 76 68 53 53 53 53 53 53 53 53 53 53 53 53 53 53 53 53 53 53 53 53 53 53 53 53 53 52 55 52 53 53 53 53 53 51 51 53 67 76 76 76 76 76 76 76 
76 76 76 76 76 68 53 53 53 53 53 53 53 53 53 53 53 53 53 53 53 53 53 52 52 52 52 52 52 52 52 52 55 52 53 53 53 53 53 51 51 53 67 76 76 76 76 76 76 76 
76 76 76 76 76 68 53 53 53 53 53 53 53 53 53 53 53 53 53 53 53 53 53 52 55 55 55 55 55 55 55 55 55 52 53 53 53 53 53 51 51 53 67 76 74 74 74 76 76 76 
76 76 76 76 76 68 50 52 53 53 53 53 53 54 54 53 53 53 53 53 53 53 53 52 55 55 55 55 55 55 55 55 55 52 53 53 53 53 53 51 51 53 67 76 76 76 76 76 76 76 
76 76 76 76 76 68 50 52 53 53 53 53 53 51 51 53 53 53 53 53 53 53 53 52 55 55 52 52 52 52 52 52 52 52 53 53 53 53 53 51 51 53 67 76 76 76 76 76 76 76 
76 76 76 76 76 68 50 52 53 53 53 53 53 51 51 53 53 53 53 53 53 53 53 52 55 55 52 53 53 53 53 53 53 53 53 53 53 53 53 51 51 53 67 76 76 76 76 76 76 76 
74 74 74 76 76 68 50 52 53 53 53 53 53 53 53 53 53 53 53 53 53 53 53 52 55 55 52 53 53 53 53 53 53 53 53 53 53 53 53 51 51 53 67 76 76 76 76 76 76 76 
76 76 76 76 76 68 50 52 53 53 53 53 53 53 53 53 53 53 53 53 53 53 53 52 55 55 52 53 53 53 53 53 53 53 53 53 53 53 53 53 53 53 67 76 75 76 75 76 76 76 
76 76 76 76 76 68 50 52 53 53 53 53 53 53 53 53 53 53 53 53 53 53 52 52 55 55 52 53 53 53 53 53 53 53 53 53 53 53 53 53 53 53 67 76 76 76 76 76 76 76 
76 76 75 76 76 68 50 52 52 52 52 52 52 53 53 53 53 53 53 53 53 53 52 50 55 55 52 53 53 53 53 53 53 53 53 53 53 53 53 53 53 53 67 76 76 76 76 76 76 76 
76 76 76 76 76 68 50 50 50 52 52 52 52 52 52 52 52 52 52 52 52 52 52 50 55 55 52 53 53 53 52 52 52 52 52 52 52 52 53 53 53 53 67 76 76 76 76 76 76 76 
76 76 76 76 76 68 50 49 50 50 50 50 50 50 50 50 50 50 50 50 50 50 50 50 55 55 52 53 53 53 52 51 51 51 51 51 51 52 53 53 53 53 67 76 76 76 76 76 76 76 
74 74 76 76 76 68 50 49 49 49 49 49 49 49 49 49 49 49 49 49 49 49 49 49 55 55 52 53 53 53 52 51 51 51 51 51 51 52 53 53 53 53 67 76 76 75 76 75 76 76 
76 76 76 76 76 68 50 55 55 55 55 55 55 55 55 55 55 55 55 55 55 55 55 55 55 55 52 53 53 53 52 51 51 51 51 51 51 52 53 53 53 53 67 76 76 76 76 76 76 76 
76 76 76 75 76 68 50 55 55 55 55 55 55 55 55 55 55 55 55 55 55 55 55 55 55 55 52 53 53 53 52 52 52 52 52 52 52 52 53 53 53 53 67 76 76 76 76 76 76 76 
76 76 76 76 76 68 50 55 55 55 55 55 55 55 55 55 55 55 55 55 55 55 55 55 55 55 52 53 53 53 53 53 53 53 53 53 53 53 53 53 53 53 67 76 76 76 76 76 76 76 
76 76 76 76 76 68 50 55 55 55 55 55 55 55 55 55 55 55 55 55 55 55 55 55 55 55 52 53 53 53 53 53 53 53 53 53 53 53 53 53 53 53 67 76 76 76 76 76 76 76 
75 76 76 76 76 68 50 49 49 49 49 49 49 49 49 49 49 49 49 49 49 49 49 49 50 50 50 50 50 50 50 50 50 50 50 50 50 50 50 50 50 50 67 76 76 76 76 76 76 76 
76 76 76 76 76 68 50 50 49 49 49 49 49 49 49 49 49 49 49 49 49 49 49 49 49 49 49 49 49 49 49 49 49 49 49 49 49 49 49 49 49 50 67 76 74 74 74 74 76 76 
76 76 76 76 76 68 50 50 50 50 50 50 50 50 50 50 50 50 50 50 50 50 50 50 50 50 50 50 50 50 50 50 50 50 50 50 50 50 50 49 49 50 67 76 76 76 76 76 76 76 
76 75 76 75 76 68 54 54 54 54 54 54 54 54 54 54 54 54 54 54 54 54 54 54 54 54 54 54 54 54 54 54 54 54 54 54 54 54 54 50 50 54 67 76 76 76 76 76 76 76 
76 76 76 76 76 68 50 72 66 66 66 66 66 66 66 66 66 66 66 66 66 66 66 66 66 66 66 66 66 66 66 66 66 66 66 66 66 66 70 54 54 72 76 76 76 76 76 76 76 76 
76 76 76 76 76 76 66 76 76 76 76 75 76 76 76 76 76 75 76 76 76 76 76 76 76 76 76 76 75 76 76 76 76 76 75 76 76 76 76 70 72 76 76 76 76 76 76 76 76 76 
76 75 76 76 76 75 76 76 76 76 76 76 76 76 76 76 76 76 76 76 76 74 74 74 74 76 76 76 76 76 76 76 76 76 76 76 76 76 76 76 76 76 76 76 76 76 76 76 76 76 
76 76 76 76 76 76 76 76 76 76 76 76 76 76 76 76 76 76 76 76 76 76 76 76 76 76 76 76 76 76 76 76 76 76 76 76 76 75 76 76 76 75 76 76 76 76 74 74 74 74 
76 76 76 76 76 76 76 76 75 76 76 76 76 76 75 76 76 76 76 76 76 76 76 76 76 76 76 76 76 76 76 76 76 76 76 76 76 76 76 76 76 76 76 76 76 76 76 76 76 76 
76 76 76 76 76 76 76 76 76 76 76 76 76 76 76 76 76 76 75 76 76 76 76 76 76 76 76 76 76 76 74 74 74 76 76 76 76 76 76 76 76 76 76 76 76 76 76 76 76 76 
76 76 74 74 74 74 74 76 76 76 76 76 76 76 76 76 76 76 76 76 76 74 74 74 76 76 76 76 76 76 76 76 76 76 76 76 76 76 76 76 76 76 76 76 76 76 76 76 76 76 
76 76 76 76 76 76 76 76 76 76 76 76 76 76 76 76 76 76 76 76 76 76 76 76 76 76 76 76 76 76 76 76 76 76 74 74 74 74 74 74 74 76 76 76 76 76 76 76 76 76 
76 76 76 76 76 76 76 76 76 76 76 76 76 74 74 74 74 76 76 76 76 76 76 76 76 76 76 76 76 76 76 76 76 76 76 76 76 76 76 76 76 76 76 76 76 76 75 76 76 76